Año;Trimestre;Provincia;ADSL;Cablemodem;Fibra óptica;Wireless;Otros;TConexiones;Nuevo_Acceso
2022;4;Buenos Aires;326;3;1;130;72;532;542,64
2022;4;Capital Federal;139;1;139;5;32;316;322,32
2022;4;Catamarca;9;11;47;1;2;70;71,4
2022;4;Chaco;25;61;47;8;3;144;146,88
2022;4;Chubut;45;74;10;31;9;169;172,38
2022;4;Córdoba;152;457;367;62;11;1049;1069,98
2022;4;Corrientes;34;80;27;9;5;155;158,1
2022;4;Entre Ríos;56;136;41;26;13;272;277,44
2022;4;Formosa;14;17;13;18;227;289;294,78
2022;4;Jujuy;18;52;43;4;1;118;120,36
2022;4;La Pampa;8;61;25;20;1;115;117,3
2022;4;La Rioja;6;54;19;6;32;117;119,34
2022;4;Mendoza;38;78;147;28;2;293;298,86
2022;4;Misiones;33;87;47;11;8;186;189,72
2022;4;Neuquén;29;73;32;24;4;162;165,24
2022;4;Río Negro;34;48;44;16;19;161;164,22
2022;4;Salta;37;97;53;12;7;206;210,12
2022;4;San Juan;39;23;12;22;8;104;106,08
2022;4;San Luis;6;43;3;82;511;645;657,9
2022;4;Santa Cruz;10;24;12;4;662;712;726,24
2022;4;Santa Fe;164;412;249;44;19;888;905,76
2022;4;Santiago Del Estero;14;81;15;7;3;120;122,4
2022;4;Tierra Del Fuego;13;41;405;157;651;1267;1292,34
2022;4;Tucumán;69;21;169;4;527;790;805,8
2022;3;Buenos Aires;340;3;1;127;70;541;551,82
2022;3;Capital Federal;141;1;129;6;32;309;315,18
2022;3;Catamarca;10;10;46;1;2;69;70,38
2022;3;Chaco;27;62;45;8;2;144;146,88
2022;3;Chubut;45;72;10;30;9;166;169,32
2022;3;Córdoba;164;465;339;61;10;1039;1059,78
2022;3;Corrientes;37;77;19;7;5;145;147,9
2022;3;Entre Ríos;60;133;37;26;13;269;274,38
2022;3;Formosa;14;26;11;17;212;280;285,6
2022;3;Jujuy;19;53;40;4;2;118;120,36
2022;3;La Pampa;8;60;24;20;4;116;118,32
2022;3;La Rioja;7;54;20;6;31;118;120,36
2022;3;Mendoza;38;79;143;28;3;291;296,82
2022;3;Misiones;36;89;39;11;8;183;186,66
2022;3;Neuquén;29;76;29;27;1;162;165,24
2022;3;Río Negro;36;48;41;17;19;161;164,22
2022;3;Salta;40;97;50;10;7;204;208,08
2022;3;San Juan;39;23;12;22;8;104;106,08
2022;3;San Luis;7;29;248;71;15;370;377,4
2022;3;Santa Cruz;10;24;11;4;582;631;643,62
2022;3;Santa Fe;184;426;215;43;20;888;905,76
2022;3;Santiago Del Estero;15;81;13;7;3;119;121,38
2022;3;Tierra Del Fuego;13;40;403;125;651;1232;1256,64
2022;3;Tucumán;78;19;162;4;519;782;797,64
2022;2;Buenos Aires;351;3;1;127;71;553;564,06
2022;2;Capital Federal;145;1;122;6;32;306;312,12
2022;2;Catamarca;12;9;42;1;2;66;67,32
2022;2;Chaco;30;61;42;8;2;143;145,86
2022;2;Chubut;45;69;10;30;9;163;166,26
2022;2;Córdoba;179;468;309;61;10;1027;1047,54
2022;2;Corrientes;38;76;18;7;5;144;146,88
2022;2;Entre Ríos;64;131;36;26;13;270;275,4
2022;2;Formosa;15;25;10;17;212;279;284,58
2022;2;Jujuy;20;54;34;4;2;114;116,28
2022;2;La Pampa;8;59;23;20;1;111;113,22
2022;2;La Rioja;8;53;19;6;31;117;119,34
2022;2;Mendoza;38;78;136;27;2;281;286,62
2022;2;Misiones;37;89;34;11;8;179;182,58
2022;2;Neuquén;30;75;29;27;1;162;165,24
2022;2;Río Negro;36;47;41;17;19;160;163,2
2022;2;Salta;43;96;47;10;7;203;207,06
2022;2;San Juan;39;20;12;22;8;101;103,02
2022;2;San Luis;7;29;248;71;15;370;377,4
2022;2;Santa Cruz;10;24;11;4;579;628;640,56
2022;2;Santa Fe;198;428;190;43;20;879;896,58
2022;2;Santiago Del Estero;17;80;12;7;3;119;121,38
2022;2;Tierra Del Fuego;13;40;403;125;651;1232;1256,64
2022;2;Tucumán;86;15;149;4;487;741;755,82
2022;1;Buenos Aires;392;3;1;126;67;589;600,78
2022;1;Capital Federal;102;1;62;6;30;201;205,02
2022;1;Catamarca;14;16;29;1;2;62;63,24
2022;1;Chaco;32;65;37;8;2;144;146,88
2022;1;Chubut;44;67;9;31;21;172;175,44
2022;1;Córdoba;196;502;236;61;10;1005;1025,1
2022;1;Corrientes;40;79;11;7;5;142;144,84
2022;1;Entre Ríos;67;139;23;26;13;268;273,36
2022;1;Formosa;16;16;5;17;202;256;261,12
2022;1;Jujuy;21;61;26;5;4;117;119,34
2022;1;La Pampa;8;59;22;20;1;110;112,2
2022;1;La Rioja;9;59;10;6;31;115;117,3
2022;1;Mendoza;49;74;123;27;1;274;279,48
2022;1;Misiones;39;92;25;8;8;172;175,44
2022;1;Neuquén;28;73;24;23;745;893;910,86
2022;1;Río Negro;39;45;38;17;18;157;160,14
2022;1;Salta;45;99;41;6;7;198;201,96
2022;1;San Juan;34;14;11;21;8;88;89,76
2022;1;San Luis;8;11;31;72;29;151;154,02
2022;1;Santa Cruz;11;23;11;4;405;454;463,08
2022;1;Santa Fe;213;445;147;45;21;871;888,42
2022;1;Santiago Del Estero;18;88;1;6;3;116;118,32
2022;1;Tierra Del Fuego;13;39;416;124;340;932;950,64
2022;1;Tucumán;93;62;86;4;487;732;746,64
2021;4;Buenos Aires;426;3;1;127;73;630;642,6
2021;4;Capital Federal;111;1;60;6;30;208;212,16
2021;4;Catamarca;16;14;25;2;2;59;60,18
2021;4;Chaco;36;63;35;8;2;144;146,88
2021;4;Chubut;46;57;10;28;19;160;163,2
2021;4;Córdoba;212;487;217;61;9;986;1005,72
2021;4;Corrientes;43;71;10;7;5;136;138,72
2021;4;Entre Ríos;70;133;23;25;13;264;269,28
2021;4;Formosa;17;15;5;16;172;225;229,5
2021;4;Jujuy;22;61;24;3;4;114;116,28
2021;4;La Pampa;8;58;20;19;1;106;108,12
2021;4;La Rioja;10;57;9;7;31;114;116,28
2021;4;Mendoza;60;72;110;25;2;269;274,38
2021;4;Misiones;42;92;22;8;8;172;175,44
2021;4;Neuquén;29;73;23;22;746;893;910,86
2021;4;Río Negro;42;44;32;17;18;153;156,06
2021;4;Salta;47;100;40;6;7;200;204
2021;4;San Juan;36;13;11;11;8;79;80,58
2021;4;San Luis;8;11;30;71;29;149;151,98
2021;4;Santa Cruz;11;23;10;4;417;465;474,3
2021;4;Santa Fe;233;444;129;44;16;866;883,32
2021;4;Santiago Del Estero;19;87;1;6;3;116;118,32
2021;4;Tierra Del Fuego;13;38;426;124;342;943;961,86
2021;4;Tucumán;98;59;79;3;486;725;739,5
2021;3;Buenos Aires;586;3;886;120;65;1660;1693,2
2021;3;Capital Federal;143;1;43;6;29;222;226,44
2021;3;Catamarca;18;12;22;2;2;56;57,12
2021;3;Chaco;38;64;28;8;2;140;142,8
2021;3;Chubut;49;56;9;23;19;156;159,12
2021;3;Córdoba;229;477;167;58;15;946;964,92
2021;3;Corrientes;45;69;8;7;5;134;136,68
2021;3;Entre Ríos;74;129;20;24;13;260;265,2
2021;3;Formosa;18;14;5;16;171;224;228,48
2021;3;Jujuy;24;61;20;3;4;112;114,24
2021;3;La Pampa;9;58;18;14;1;100;102
2021;3;La Rioja;11;55;9;7;30;112;114,24
2021;3;Mendoza;91;71;71;22;828;1083;1104,66
2021;3;Misiones;43;89;11;7;8;158;161,16
2021;3;Neuquén;30;74;16;19;640;779;794,58
2021;3;Río Negro;48;45;19;15;18;145;147,9
2021;3;Salta;49;98;36;6;6;195;198,9
2021;3;San Juan;40;13;7;11;8;79;80,58
2021;3;San Luis;8;12;27;69;29;145;147,9
2021;3;Santa Cruz;12;23;6;4;3;48;48,96
2021;3;Santa Fe;246;443;93;43;16;841;857,82
2021;3;Santiago Del Estero;20;86;909;6;3;1024;1044,48
2021;3;Tierra Del Fuego;13;37;6;16;390;462;471,24
2021;3;Tucumán;104;54;71;2;743;974;993,48
2021;2;Buenos Aires;603;3;854;114;58;1632;1664,64
2021;2;Capital Federal;149;1;41;6;29;226;230,52
2021;2;Catamarca;20;9;22;1;2;54;55,08
2021;2;Chaco;40;63;28;8;2;141;143,82
2021;2;Chubut;49;41;6;24;19;139;141,78
2021;2;Córdoba;240;468;152;56;16;932;950,64
2021;2;Corrientes;47;67;4;7;5;130;132,6
2021;2;Entre Ríos;78;125;18;24;13;258;263,16
2021;2;Formosa;20;13;4;16;171;224;228,48
2021;2;Jujuy;25;61;20;3;4;113;115,26
2021;2;La Pampa;9;57;17;13;1;97;98,94
2021;2;La Rioja;12;54;9;6;30;111;113,22
2021;2;Mendoza;92;71;45;22;827;1057;1078,14
2021;2;Misiones;45;88;10;5;8;156;159,12
2021;2;Neuquén;30;73;16;19;640;778;793,56
2021;2;Río Negro;48;44;19;15;18;144;146,88
2021;2;Salta;51;96;32;6;6;191;194,82
2021;2;San Juan;40;12;7;11;8;78;79,56
2021;2;San Luis;8;11;28;67;36;150;153
2021;2;Santa Cruz;12;23;6;4;3;48;48,96
2021;2;Santa Fe;257;432;90;44;18;841;857,82
2021;2;Santiago Del Estero;21;84;909;5;4;1023;1043,46
2021;2;Tierra Del Fuego;13;23;6;14;316;372;379,44
2021;2;Tucumán;110;48;72;2;743;975;994,5
2021;1;Buenos Aires;630;2;822;99;58;1611;1643,22
2021;1;Capital Federal;160;1;40;6;29;236;240,72
2021;1;Catamarca;26;4;19;322;2;373;380,46
2021;1;Chaco;43;61;25;8;2;139;141,78
2021;1;Chubut;46;41;3;24;19;133;135,66
2021;1;Córdoba;260;445;135;54;17;911;929,22
2021;1;Corrientes;49;63;3;6;5;126;128,52
2021;1;Entre Ríos;84;118;17;21;12;252;257,04
2021;1;Formosa;21;11;3;16;380;431;439,62
2021;1;Jujuy;32;54;17;3;4;110;112,2
2021;1;La Pampa;9;59;16;12;1;97;98,94
2021;1;La Rioja;17;35;1;250;30;333;339,66
2021;1;Mendoza;92;69;39;18;833;1051;1072,02
2021;1;Misiones;48;82;7;5;7;149;151,98
2021;1;Neuquén;30;70;14;18;632;764;779,28
2021;1;Río Negro;49;42;18;14;18;141;143,82
2021;1;Salta;55;89;31;6;6;187;190,74
2021;1;San Juan;40;12;7;11;8;78;79,56
2021;1;San Luis;8;11;28;64;36;147;149,94
2021;1;Santa Cruz;12;23;6;4;390;435;443,7
2021;1;Santa Fe;277;421;71;39;18;826;842,52
2021;1;Santiago Del Estero;26;76;570;5;4;681;694,62
2021;1;Tierra Del Fuego;13;27;6;0;316;362;369,24
2021;1;Tucumán;147;12;70;2;740;971;990,42
2020;4;Buenos Aires;636;2;805;93;58;1594;1625,88
2020;4;Capital Federal;163;1;40;5;29;238;242,76
2020;4;Catamarca;27;5;18;322;2;374;381,48
2020;4;Chaco;44;61;24;8;2;139;141,78
2020;4;Chubut;46;40;3;23;19;131;133,62
2020;4;Córdoba;267;439;126;53;18;903;921,06
2020;4;Corrientes;50;61;3;6;5;125;127,5
2020;4;Entre Ríos;86;114;16;20;12;248;252,96
2020;4;Formosa;21;11;2;15;380;429;437,58
2020;4;Jujuy;33;53;16;1;3;106;108,12
2020;4;La Pampa;9;59;15;12;1;96;97,92
2020;4;La Rioja;18;35;1;250;30;334;340,68
2020;4;Mendoza;92;68;36;18;833;1047;1067,94
2020;4;Misiones;49;80;7;4;7;147;149,94
2020;4;Neuquén;30;71;14;18;632;765;780,3
2020;4;Río Negro;49;42;18;14;18;141;143,82
2020;4;Salta;57;88;31;6;6;188;191,76
2020;4;San Juan;40;7;7;10;8;72;73,44
2020;4;San Luis;8;12;27;63;36;146;148,92
2020;4;Santa Cruz;12;20;1;5;3;41;41,82
2020;4;Santa Fe;287;415;63;39;17;821;837,42
2020;4;Santiago Del Estero;27;71;570;5;4;677;690,54
2020;4;Tierra Del Fuego;13;26;6;0;316;361;368,22
2020;4;Tucumán;149;11;68;2;740;970;989,4
2020;3;Buenos Aires;654;2;749;94;56;1555;1586,1
2020;3;Capital Federal;170;1;39;4;29;243;247,86
2020;3;Catamarca;27;4;17;261;2;311;317,22
2020;3;Chaco;46;59;21;7;2;135;137,7
2020;3;Chubut;46;39;3;23;19;130;132,6
2020;3;Córdoba;276;431;102;48;10;867;884,34
2020;3;Corrientes;51;59;3;6;5;124;126,48
2020;3;Entre Ríos;88;107;14;20;12;241;245,82
2020;3;Formosa;22;10;2;15;393;442;450,84
2020;3;Jujuy;33;58;11;952;4;1058;1079,16
2020;3;La Pampa;9;57;15;12;1;94;95,88
2020;3;La Rioja;17;35;1;250;35;338;344,76
2020;3;Mendoza;92;65;33;18;868;1076;1097,52
2020;3;Misiones;50;78;3;3;9;143;145,86
2020;3;Neuquén;30;70;11;17;737;865;882,3
2020;3;Río Negro;50;40;10;13;18;131;133,62
2020;3;Salta;58;84;25;6;7;180;183,6
2020;3;San Juan;40;9;6;14;8;77;78,54
2020;3;San Luis;8;10;6;62;36;122;124,44
2020;3;Santa Cruz;13;16;1;7;2;39;39,78
2020;3;Santa Fe;295;406;46;37;19;803;819,06
2020;3;Santiago Del Estero;26;71;555;4;4;660;673,2
2020;3;Tierra Del Fuego;13;26;0;0;310;349;355,98
2020;3;Tucumán;150;12;60;2;762;986;1005,72
2020;2;Buenos Aires;661;2;723;92;57;1535;1565,7
2020;2;Capital Federal;179;1;39;4;29;252;257,04
2020;2;Catamarca;27;4;15;261;2;309;315,18
2020;2;Chaco;47;56;17;6;2;128;130,56
2020;2;Chubut;46;38;1;18;6;109;111,18
2020;2;Córdoba;283;415;86;45;8;837;853,74
2020;2;Corrientes;51;56;3;4;5;119;121,38
2020;2;Entre Ríos;89;99;14;20;11;233;237,66
2020;2;Formosa;22;9;2;15;169;217;221,34
2020;2;Jujuy;33;39;5;952;17;1046;1066,92
2020;2;La Pampa;9;54;14;11;1;89;90,78
2020;2;La Rioja;17;35;1;250;35;338;344,76
2020;2;Mendoza;92;63;30;16;802;1003;1023,06
2020;2;Misiones;51;74;3;3;9;140;142,8
2020;2;Neuquén;30;68;11;16;1;126;128,52
2020;2;Río Negro;50;40;10;11;18;129;131,58
2020;2;Salta;60;82;24;5;7;178;181,56
2020;2;San Juan;40;8;6;7;9;70;71,4
2020;2;San Luis;8;8;6;61;36;119;121,38
2020;2;Santa Cruz;13;16;1;7;2;39;39,78
2020;2;Santa Fe;300;382;47;30;19;778;793,56
2020;2;Santiago Del Estero;26;72;355;3;4;460;469,2
2020;2;Tierra Del Fuego;13;26;0;0;310;349;355,98
2020;2;Tucumán;150;10;55;1;762;978;997,56
2020;1;Buenos Aires;673;2;721;85;18;1499;1528,98
2020;1;Capital Federal;184;1;39;4;29;257;262,14
2020;1;Catamarca;22;3;12;261;2;300;306
2020;1;Chaco;46;54;12;6;2;120;122,4
2020;1;Chubut;46;27;1;17;5;96;97,92
2020;1;Córdoba;286;406;69;42;9;812;828,24
2020;1;Corrientes;51;53;2;2;5;113;115,26
2020;1;Entre Ríos;90;95;13;19;14;231;235,62
2020;1;Formosa;21;9;2;15;169;216;220,32
2020;1;Jujuy;32;39;3;942;17;1033;1053,66
2020;1;La Pampa;9;54;14;11;2;90;91,8
2020;1;La Rioja;13;35;0;251;29;328;334,56
2020;1;Mendoza;92;50;28;12;722;904;922,08
2020;1;Misiones;51;69;1;460;11;592;603,84
2020;1;Neuquén;29;66;11;15;729;850;867
2020;1;Río Negro;48;38;10;11;18;125;127,5
2020;1;Salta;60;76;23;4;7;170;173,4
2020;1;San Juan;40;6;6;7;5;64;65,28
2020;1;San Luis;8;8;5;58;36;115;117,3
2020;1;Santa Cruz;13;16;1;7;2;39;39,78
2020;1;Santa Fe;302;384;35;30;19;770;785,4
2020;1;Santiago Del Estero;25;70;200;3;5;303;309,06
2020;1;Tierra Del Fuego;13;26;0;0;308;347;353,94
2020;1;Tucumán;143;10;45;1;347;546;556,92
2019;4;Buenos Aires;720;2;669;87;18;1496;1525,92
2019;4;Capital Federal;197;1;36;4;29;267;272,34
2019;4;Catamarca;23;3;10;261;2;299;304,98
2019;4;Chaco;49;54;9;5;2;119;121,38
2019;4;Chubut;47;27;1;15;5;95;96,9
2019;4;Córdoba;297;410;53;38;9;807;823,14
2019;4;Corrientes;53;52;2;2;5;114;116,28
2019;4;Entre Ríos;93;99;13;19;15;239;243,78
2019;4;Formosa;22;9;2;15;169;217;221,34
2019;4;Jujuy;33;38;873;814;17;1775;1810,5
2019;4;La Pampa;15;57;5;11;2;90;91,8
2019;4;La Rioja;14;35;0;251;29;329;335,58
2019;4;Mendoza;97;50;25;14;730;916;934,32
2019;4;Misiones;53;70;847;441;12;1423;1451,46
2019;4;Neuquén;30;61;11;14;854;970;989,4
2019;4;Río Negro;50;38;10;11;18;127;129,54
2019;4;Salta;63;76;22;3;8;172;175,44
2019;4;San Juan;41;6;5;7;5;64;65,28
2019;4;San Luis;9;8;6;55;36;114;116,28
2019;4;Santa Cruz;13;16;1;7;2;39;39,78
2019;4;Santa Fe;312;382;27;27;20;768;783,36
2019;4;Santiago Del Estero;25;71;200;3;5;304;310,08
2019;4;Tierra Del Fuego;13;27;0;0;310;350;357
2019;4;Tucumán;147;11;40;725;348;1271;1296,42
2019;3;Buenos Aires;1;2;425;86;27;541;551,82
2019;3;Capital Federal;300;1;25;4;31;361;368,22
2019;3;Catamarca;24;6;13;244;2;289;294,78
2019;3;Chaco;50;49;8;5;2;114;116,28
2019;3;Chubut;37;27;2;15;8;89;90,78
2019;3;Córdoba;308;399;30;37;9;783;798,66
2019;3;Corrientes;53;50;2;2;5;112;114,24
2019;3;Entre Ríos;95;96;13;19;15;238;242,76
2019;3;Formosa;22;8;1;14;162;207;211,14
2019;3;Jujuy;33;36;274;812;17;1172;1195,44
2019;3;La Pampa;19;53;5;11;2;90;91,8
2019;3;La Rioja;14;35;11;251;41;352;359,04
2019;3;Mendoza;149;54;7;13;2;225;229,5
2019;3;Misiones;54;66;829;419;12;1380;1407,6
2019;3;Neuquén;43;60;6;14;3;126;128,52
2019;3;Río Negro;67;37;10;11;19;144;146,88
2019;3;Salta;66;74;733;2;9;884;901,68
2019;3;San Juan;52;7;1;7;6;73;74,46
2019;3;San Luis;13;11;350;62;36;472;481,44
2019;3;Santa Cruz;11;17;969;7;3;1007;1027,14
2019;3;Santa Fe;319;377;19;24;21;760;775,2
2019;3;Santiago Del Estero;25;71;219;3;34;352;359,04
2019;3;Tierra Del Fuego;20;27;651;0;1;699;712,98
2019;3;Tucumán;151;12;116;684;324;1287;1312,74
2019;2;Buenos Aires;1;2;383;75;33;494;503,88
2019;2;Capital Federal;310;1;36;4;4;355;362,1
2019;2;Catamarca;26;6;13;146;2;193;196,86
2019;2;Chaco;51;47;4;5;2;109;111,18
2019;2;Chubut;37;26;2;14;8;87;88,74
2019;2;Córdoba;315;388;23;34;15;775;790,5
2019;2;Corrientes;54;47;2;2;6;111;113,22
2019;2;Entre Ríos;97;91;13;17;18;236;240,72
2019;2;Formosa;22;9;1;14;162;208;212,16
2019;2;Jujuy;33;31;274;812;22;1172;1195,44
2019;2;La Pampa;19;52;5;11;3;90;91,8
2019;2;La Rioja;15;35;11;251;41;353;360,06
2019;2;Mendoza;149;54;7;13;2;225;229,5
2019;2;Misiones;55;64;543;421;12;1095;1116,9
2019;2;Neuquén;43;59;5;13;3;123;125,46
2019;2;Río Negro;68;37;4;10;20;139;141,78
2019;2;Salta;69;62;725;1;9;866;883,32
2019;2;San Juan;52;7;1;3;7;70;71,4
2019;2;San Luis;11;10;347;57;38;463;472,26
2019;2;Santa Cruz;11;10;379;7;3;410;418,2
2019;2;Santa Fe;325;355;18;22;23;743;757,86
2019;2;Santiago Del Estero;24;65;219;3;35;346;352,92
2019;2;Tierra Del Fuego;20;26;651;0;1;698;711,96
2019;2;Tucumán;153;12;116;684;321;1286;1311,72
2019;1;Buenos Aires;1;2;336;65;20;424;432,48
2019;1;Capital Federal;328;1;32;4;4;369;376,38
2019;1;Catamarca;27;4;16;0;2;49;49,98
2019;1;Chaco;53;44;2;4;1;104;106,08
2019;1;Chubut;37;23;2;14;3;79;80,58
2019;1;Córdoba;323;364;20;25;12;744;758,88
2019;1;Corrientes;56;43;2;2;58;161;164,22
2019;1;Entre Ríos;101;90;13;16;12;232;236,64
2019;1;Formosa;23;8;940;14;62;1047;1067,94
2019;1;Jujuy;33;12;153;640;44;882;899,64
2019;1;La Pampa;19;57;3;9;1;89;90,78
2019;1;La Rioja;16;35;12;252;41;356;363,12
2019;1;Mendoza;149;40;6;10;2;207;211,14
2019;1;Misiones;55;59;465;426;8;1013;1033,26
2019;1;Neuquén;41;56;3;13;2;115;117,3
2019;1;Río Negro;68;34;4;10;5;121;123,42
2019;1;Salta;74;58;647;1;2;782;797,64
2019;1;San Juan;52;6;808;3;1;870;887,4
2019;1;San Luis;11;8;378;53;24;474;483,48
2019;1;Santa Cruz;11;5;382;7;3;408;416,16
2019;1;Santa Fe;340;340;16;23;18;737;751,74
2019;1;Santiago Del Estero;25;62;23;3;99;212;216,24
2019;1;Tierra Del Fuego;20;24;2;0;1;47;47,94
2019;1;Tucumán;159;12;118;678;321;1288;1313,76
2018;4;Buenos Aires;1;2;296;65;20;384;391,68
2018;4;Capital Federal;328;1;33;4;4;370;377,4
2018;4;Catamarca;27;4;16;0;2;49;49,98
2018;4;Chaco;53;44;2;3;1;103;105,06
2018;4;Chubut;37;23;952;14;3;1029;1049,58
2018;4;Córdoba;329;356;18;22;13;738;752,76
2018;4;Corrientes;56;42;796;2;30;926;944,52
2018;4;Entre Ríos;101;86;5;15;14;221;225,42
2018;4;Formosa;23;8;887;14;57;989;1008,78
2018;4;Jujuy;33;12;153;640;44;882;899,64
2018;4;La Pampa;19;55;3;8;1;86;87,72
2018;4;La Rioja;16;35;12;252;36;351;358,02
2018;4;Mendoza;149;40;6;10;2;207;211,14
2018;4;Misiones;56;54;465;426;6;1007;1027,14
2018;4;Neuquén;41;56;3;12;2;114;116,28
2018;4;Río Negro;68;34;1;8;5;116;118,32
2018;4;Salta;74;58;638;253;2;1025;1045,5
2018;4;San Juan;52;6;806;3;1;868;885,36
2018;4;San Luis;11;8;378;53;24;474;483,48
2018;4;Santa Cruz;11;5;382;6;3;407;415,14
2018;4;Santa Fe;336;323;14;19;29;721;735,42
2018;4;Santiago Del Estero;25;61;23;3;81;193;196,86
2018;4;Tierra Del Fuego;20;23;2;0;1;46;46,92
2018;4;Tucumán;159;12;119;686;314;1290;1315,8
2018;3;Buenos Aires;1;2;156;62;26;247;251,94
2018;3;Capital Federal;334;1;36;4;9;384;391,68
2018;3;Catamarca;28;4;15;1;2;50;51
2018;3;Chaco;54;42;2;3;1;102;104,04
2018;3;Chubut;59;23;1;14;7;104;106,08
2018;3;Córdoba;338;342;16;19;11;726;740,52
2018;3;Corrientes;56;41;212;1;32;342;348,84
2018;3;Entre Ríos;103;84;2;15;80;284;289,68
2018;3;Formosa;23;8;817;14;57;919;937,38
2018;3;Jujuy;33;11;32;641;43;760;775,2
2018;3;La Pampa;12;55;8;7;987;1069;1090,38
2018;3;La Rioja;17;35;13;253;35;353;360,06
2018;3;Mendoza;151;40;6;8;2;207;211,14
2018;3;Misiones;56;51;512;391;56;1066;1087,32
2018;3;Neuquén;47;54;998;12;3;1114;1136,28
2018;3;Río Negro;69;33;1;5;5;113;115,26
2018;3;Salta;77;54;678;234;1;1044;1064,88
2018;3;San Juan;54;6;826;3;1;890;907,8
2018;3;San Luis;11;8;368;53;2;442;450,84
2018;3;Santa Cruz;19;5;585;6;4;619;631,38
2018;3;Santa Fe;339;313;12;16;15;695;708,9
2018;3;Santiago Del Estero;26;59;23;2;81;191;194,82
2018;3;Tierra Del Fuego;19;23;2;1;2;47;47,94
2018;3;Tucumán;161;9;110;252;315;847;863,94
2018;2;Buenos Aires;1;2;144;71;28;246;250,92
2018;2;Capital Federal;342;978;36;4;9;1369;1396,38
2018;2;Catamarca;27;4;15;1;2;49;49,98
2018;2;Chaco;54;41;562;2;1;660;673,2
2018;2;Chubut;59;20;1;14;7;101;103,02
2018;2;Córdoba;345;328;14;16;10;713;727,26
2018;2;Corrientes;57;40;201;1;32;331;337,62
2018;2;Entre Ríos;105;80;2;12;80;279;284,58
2018;2;Formosa;24;7;18;14;57;120;122,4
2018;2;Jujuy;34;11;23;640;43;751;766,02
2018;2;La Pampa;12;54;8;7;987;1068;1089,36
2018;2;La Rioja;17;35;13;253;35;353;360,06
2018;2;Mendoza;153;37;3;6;2;201;205,02
2018;2;Misiones;57;48;512;391;56;1064;1085,28
2018;2;Neuquén;47;53;998;13;3;1114;1136,28
2018;2;Río Negro;69;33;1;4;5;112;114,24
2018;2;Salta;78;53;678;234;1;1044;1064,88
2018;2;San Juan;54;5;826;3;1;889;906,78
2018;2;San Luis;11;8;368;16;2;405;413,1
2018;2;Santa Cruz;19;4;585;7;4;619;631,38
2018;2;Santa Fe;338;304;11;16;15;684;697,68
2018;2;Santiago Del Estero;26;56;23;2;81;188;191,76
2018;2;Tierra Del Fuego;19;23;531;1;2;576;587,52
2018;2;Tucumán;160;9;110;252;315;846;862,92
2018;1;Buenos Aires;1;2;134;64;31;232;236,64
2018;1;Capital Federal;350;968;36;3;9;1366;1393,32
2018;1;Catamarca;27;4;15;1;2;49;49,98
2018;1;Chaco;55;40;383;388;1;867;884,34
2018;1;Chubut;56;20;1;14;7;98;99,96
2018;1;Córdoba;349;327;13;13;11;713;727,26
2018;1;Corrientes;57;35;888;1;33;1014;1034,28
2018;1;Entre Ríos;107;76;4;11;80;278;283,56
2018;1;Formosa;24;7;17;2;57;107;109,14
2018;1;Jujuy;34;10;23;28;43;138;140,76
2018;1;La Pampa;11;51;8;11;2;83;84,66
2018;1;La Rioja;17;35;13;253;35;353;360,06
2018;1;Mendoza;153;37;3;6;2;201;205,02
2018;1;Misiones;56;47;328;5;56;492;501,84
2018;1;Neuquén;47;55;1;12;3;118;120,36
2018;1;Río Negro;69;32;1;4;5;111;113,22
2018;1;Salta;80;52;118;204;1;455;464,1
2018;1;San Juan;54;5;826;2;1;888;905,76
2018;1;San Luis;11;8;368;16;2;405;413,1
2018;1;Santa Cruz;19;4;2;7;3;35;35,7
2018;1;Santa Fe;342;300;11;12;15;680;693,6
2018;1;Santiago Del Estero;27;55;23;1;81;187;190,74
2018;1;Tierra Del Fuego;19;10;531;1;2;563;574,26
2018;1;Tucumán;159;9;107;368;50;693;706,86
2017;4;Buenos Aires;1;2;131;60;31;225;229,5
2017;4;Capital Federal;571;962;36;3;10;1582;1613,64
2017;4;Catamarca;27;263;11;1;2;304;310,08
2017;4;Chaco;55;40;389;380;1;865;882,3
2017;4;Chubut;56;15;1;14;7;93;94,86
2017;4;Córdoba;350;325;13;12;11;711;725,22
2017;4;Corrientes;57;35;894;1;35;1022;1042,44
2017;4;Entre Ríos;108;74;2;10;86;280;285,6
2017;4;Formosa;23;7;19;2;51;102;104,04
2017;4;Jujuy;34;10;20;28;34;126;128,52
2017;4;La Pampa;11;50;8;11;2;82;83,64
2017;4;La Rioja;17;35;14;253;31;350;357
2017;4;Mendoza;153;16;3;6;2;180;183,6
2017;4;Misiones;56;47;95;5;54;257;262,14
2017;4;Neuquén;47;54;1;12;3;117;119,34
2017;4;Río Negro;69;30;1;4;5;109;111,18
2017;4;Salta;81;50;127;158;1;417;425,34
2017;4;San Juan;54;451;812;2;1;1320;1346,4
2017;4;San Luis;11;1;335;17;2;366;373,32
2017;4;Santa Cruz;19;2;582;5;4;612;624,24
2017;4;Santa Fe;342;294;11;11;15;673;686,46
2017;4;Santiago Del Estero;27;40;19;1;80;167;170,34
2017;4;Tierra Del Fuego;19;7;530;1;2;559;570,18
2017;4;Tucumán;157;5;105;102;319;688;701,76
2017;3;Buenos Aires;1;2;125;35;39;202;206,04
2017;3;Capital Federal;583;941;33;3;10;1570;1601,4
2017;3;Catamarca;27;4;12;1;2;46;46,92
2017;3;Chaco;55;37;456;36;1;585;596,7
2017;3;Chubut;56;6;1;14;7;84;85,68
2017;3;Córdoba;345;319;11;7;15;697;710,94
2017;3;Corrientes;56;34;947;1;27;1065;1086,3
2017;3;Entre Ríos;108;70;2;6;63;249;253,98
2017;3;Formosa;23;7;428;2;12;472;481,44
2017;3;Jujuy;34;9;20;23;8;94;95,88
2017;3;La Pampa;11;50;5;12;2;80;81,6
2017;3;La Rioja;17;35;14;252;25;343;349,86
2017;3;Mendoza;154;34;3;29;2;222;226,44
2017;3;Misiones;56;44;110;5;9;224;228,48
2017;3;Neuquén;48;52;1;12;3;116;118,32
2017;3;Río Negro;69;30;1;3;4;107;109,14
2017;3;Salta;81;50;127;158;1;417;425,34
2017;3;San Juan;54;5;816;1;1;877;894,54
2017;3;San Luis;11;8;347;26;2;394;401,88
2017;3;Santa Cruz;19;5;2;5;3;34;34,68
2017;3;Santa Fe;323;291;6;5;37;662;675,24
2017;3;Santiago Del Estero;28;54;19;911;35;1047;1067,94
2017;3;Tierra Del Fuego;22;7;622;1;2;654;667,08
2017;3;Tucumán;154;6;106;40;305;611;623,22
2017;2;Buenos Aires;1;2;119;22;24;168;171,36
2017;2;Capital Federal;615;932;39;3;11;1600;1632
2017;2;Catamarca;26;255;14;1;34;330;336,6
2017;2;Chaco;54;36;458;52;39;639;651,78
2017;2;Chubut;44;1;916;13;5;979;998,58
2017;2;Córdoba;342;303;4;6;2;657;670,14
2017;2;Corrientes;55;33;258;1;31;378;385,56
2017;2;Entre Ríos;108;68;254;6;71;507;517,14
2017;2;Formosa;22;6;17;1;13;59;60,18
2017;2;Jujuy;34;9;22;0;35;100;102
2017;2;La Pampa;13;48;5;6;511;583;594,66
2017;2;La Rioja;16;0;15;2;28;61;62,22
2017;2;Mendoza;153;13;3;27;2;198;201,96
2017;2;Misiones;57;43;103;5;9;217;221,34
2017;2;Neuquén;52;50;1;12;3;118;120,36
2017;2;Río Negro;67;29;961;3;1;1061;1082,22
2017;2;Salta;80;27;115;158;804;1184;1207,68
2017;2;San Juan;49;451;772;1;915;2188;2231,76
2017;2;San Luis;11;1;354;26;375;767;782,34
2017;2;Santa Cruz;15;3;1;5;2;26;26,52
2017;2;Santa Fe;330;228;3;5;1;567;578,34
2017;2;Santiago Del Estero;28;4;19;911;29;991;1010,82
2017;2;Tierra Del Fuego;23;7;665;1;2;698;711,96
2017;2;Tucumán;149;5;116;14;45;329;335,58
2017;1;Buenos Aires;2;1;119;21;24;167;170,34
2017;1;Capital Federal;429;918;38;3;11;1399;1426,98
2017;1;Catamarca;26;248;14;1;34;323;329,46
2017;1;Chaco;54;34;252;52;39;431;439,62
2017;1;Chubut;44;999;916;13;5;1977;2016,54
2017;1;Córdoba;336;293;5;6;1;641;653,82
2017;1;Corrientes;55;32;236;1;31;355;362,1
2017;1;Entre Ríos;109;65;230;6;71;481;490,62
2017;1;Formosa;22;6;16;1;13;58;59,16
2017;1;Jujuy;34;9;22;0;34;99;100,98
2017;1;La Pampa;13;47;5;6;517;588;599,76
2017;1;La Rioja;16;0;15;2;28;61;62,22
2017;1;Mendoza;153;13;3;27;2;198;201,96
2017;1;Misiones;57;40;101;5;8;211;215,22
2017;1;Neuquén;52;48;1;12;3;116;118,32
2017;1;Río Negro;67;29;954;3;1;1054;1075,08
2017;1;Salta;80;27;114;158;679;1058;1079,16
2017;1;San Juan;49;451;772;1;907;2180;2223,6
2017;1;San Luis;11;1;354;26;375;767;782,34
2017;1;Santa Cruz;16;3;1;5;2;27;27,54
2017;1;Santa Fe;327;226;3;5;1;562;573,24
2017;1;Santiago Del Estero;30;4;19;911;29;993;1012,86
2017;1;Tierra Del Fuego;23;7;665;1;2;698;711,96
2017;1;Tucumán;147;5;116;14;45;327;333,54
2016;4;Buenos Aires;2;1;119;21;24;167;170,34
2016;4;Capital Federal;435;915;38;3;11;1402;1430,04
2016;4;Catamarca;27;250;14;1;34;326;332,52
2016;4;Chaco;55;34;248;52;39;428;436,56
2016;4;Chubut;44;955;916;13;5;1933;1971,66
2016;4;Córdoba;337;289;3;6;789;1424;1452,48
2016;4;Corrientes;55;31;233;1;31;351;358,02
2016;4;Entre Ríos;109;64;226;6;71;476;485,52
2016;4;Formosa;22;6;16;1;13;58;59,16
2016;4;Jujuy;34;9;22;0;34;99;100,98
2016;4;La Pampa;13;47;5;6;522;593;604,86
2016;4;La Rioja;16;0;16;2;28;62;63,24
2016;4;Mendoza;153;13;3;27;2;198;201,96
2016;4;Misiones;58;39;100;5;8;210;214,2
2016;4;Neuquén;52;46;1;12;3;114;116,28
2016;4;Río Negro;67;28;954;3;1;1053;1074,06
2016;4;Salta;79;27;110;158;621;995;1014,9
2016;4;San Juan;49;451;772;1;907;2180;2223,6
2016;4;San Luis;11;1;354;26;375;767;782,34
2016;4;Santa Cruz;16;3;1;5;2;27;27,54
2016;4;Santa Fe;327;226;3;5;1;562;573,24
2016;4;Santiago Del Estero;30;4;19;911;29;993;1012,86
2016;4;Tierra Del Fuego;23;7;665;1;2;698;711,96
2016;4;Tucumán;147;4;116;14;45;326;332,52
2016;3;Buenos Aires;2;1;113;19;24;159;162,18
2016;3;Capital Federal;448;905;37;3;11;1404;1432,08
2016;3;Catamarca;27;248;14;1;18;308;314,16
2016;3;Chaco;56;33;232;2;15;338;344,76
2016;3;Chubut;44;935;916;13;5;1913;1951,26
2016;3;Córdoba;348;285;3;6;395;1037;1057,74
2016;3;Corrientes;56;31;217;1;22;327;333,54
2016;3;Entre Ríos;113;62;206;6;64;451;460,02
2016;3;Formosa;22;6;9;0;2;39;39,78
2016;3;Jujuy;34;8;22;0;30;94;95,88
2016;3;La Pampa;13;46;5;6;515;585;596,7
2016;3;La Rioja;17;0;15;2;22;56;57,12
2016;3;Mendoza;153;13;3;28;2;199;202,98
2016;3;Misiones;60;38;79;5;7;189;192,78
2016;3;Neuquén;52;45;1;12;3;113;115,26
2016;3;Río Negro;67;28;942;3;1;1041;1061,82
2016;3;Salta;81;26;90;157;565;919;937,38
2016;3;San Juan;49;451;770;1;903;2174;2217,48
2016;3;San Luis;11;1;354;23;371;760;775,2
2016;3;Santa Cruz;16;3;817;5;2;843;859,86
2016;3;Santa Fe;335;223;3;5;1;567;578,34
2016;3;Santiago Del Estero;32;4;19;3;8;66;67,32
2016;3;Tierra Del Fuego;23;6;665;1;2;697;710,94
2016;3;Tucumán;147;4;116;53;41;361;368,22
2016;2;Buenos Aires;2;1;113;21;26;163;166,26
2016;2;Capital Federal;451;892;37;2;13;1395;1422,9
2016;2;Catamarca;26;245;14;1;34;320;326,4
2016;2;Chaco;56;32;221;52;41;402;410,04
2016;2;Chubut;44;867;916;13;5;1845;1881,9
2016;2;Córdoba;349;278;2;6;1;636;648,72
2016;2;Corrientes;56;30;203;1;43;333;339,66
2016;2;Entre Ríos;113;59;169;6;193;540;550,8
2016;2;Formosa;22;6;6;1;14;49;49,98
2016;2;Jujuy;34;7;22;0;35;98;99,96
2016;2;La Pampa;13;45;5;6;547;616;628,32
2016;2;La Rioja;17;0;15;2;28;62;63,24
2016;2;Mendoza;153;13;3;29;2;200;204
2016;2;Misiones;60;36;77;5;15;193;196,86
2016;2;Neuquén;52;42;1;12;3;110;112,2
2016;2;Río Negro;67;28;939;3;1;1038;1058,76
2016;2;Salta;79;25;85;151;539;879;896,58
2016;2;San Juan;49;451;770;1;908;2179;2222,58
2016;2;San Luis;11;1;354;30;377;773;788,46
2016;2;Santa Cruz;15;3;396;5;3;422;430,44
2016;2;Santa Fe;336;219;3;5;1;564;575,28
2016;2;Santiago Del Estero;32;4;19;911;30;996;1015,92
2016;2;Tierra Del Fuego;23;6;665;1;2;697;710,94
2016;2;Tucumán;145;3;116;58;49;371;378,42
2016;1;Buenos Aires;2;1;111;21;26;161;164,22
2016;1;Capital Federal;454;832;36;2;13;1337;1363,74
2016;1;Catamarca;26;243;15;1;34;319;325,38
2016;1;Chaco;56;30;211;52;41;390;397,8
2016;1;Chubut;44;834;916;13;5;1812;1848,24
2016;1;Córdoba;351;252;674;6;386;1669;1702,38
2016;1;Corrientes;55;28;192;1;45;321;327,42
2016;1;Entre Ríos;113;55;146;6;193;513;523,26
2016;1;Formosa;22;5;5;1;14;47;47,94
2016;1;Jujuy;33;7;22;0;35;97;98,94
2016;1;La Pampa;13;42;5;6;549;615;627,3
2016;1;La Rioja;17;0;16;2;28;63;64,26
2016;1;Mendoza;153;13;3;34;2;205;209,1
2016;1;Misiones;60;33;70;5;15;183;186,66
2016;1;Neuquén;52;36;1;13;3;105;107,1
2016;1;Río Negro;67;27;937;3;1;1035;1055,7
2016;1;Salta;79;23;73;132;507;814;830,28
2016;1;San Juan;49;451;770;1;908;2179;2222,58
2016;1;San Luis;11;1;354;27;377;770;785,4
2016;1;Santa Cruz;16;3;396;5;2;422;430,44
2016;1;Santa Fe;338;205;3;5;1;552;563,04
2016;1;Santiago Del Estero;33;4;19;911;30;997;1016,94
2016;1;Tierra Del Fuego;23;5;665;1;2;696;709,92
2016;1;Tucumán;144;2;116;74;49;385;392,7
2015;4;Buenos Aires;2;1;103;20;26;152;155,04
2015;4;Capital Federal;455;880;20;2;13;1370;1397,4
2015;4;Catamarca;26;242;15;1;34;318;324,36
2015;4;Chaco;57;29;186;52;41;365;372,3
2015;4;Chubut;44;811;916;14;5;1790;1825,8
2015;4;Córdoba;354;266;480;6;385;1491;1520,82
2015;4;Corrientes;56;28;177;1;45;307;313,14
2015;4;Entre Ríos;114;53;122;6;194;489;498,78
2015;4;Formosa;22;5;4;1;14;46;46,92
2015;4;Jujuy;33;7;22;0;35;97;98,94
2015;4;La Pampa;13;43;4;6;374;440;448,8
2015;4;La Rioja;17;0;16;2;28;63;64,26
2015;4;Mendoza;153;13;3;38;2;209;213,18
2015;4;Misiones;60;33;48;5;15;161;164,22
2015;4;Neuquén;52;39;1;13;3;108;110,16
2015;4;Río Negro;67;27;915;3;1;1013;1033,26
2015;4;Salta;79;22;47;129;554;831;847,62
2015;4;San Juan;49;451;770;1;908;2179;2222,58
2015;4;San Luis;11;1;354;30;377;773;788,46
2015;4;Santa Cruz;16;3;396;5;2;422;430,44
2015;4;Santa Fe;340;213;3;5;1;562;573,24
2015;4;Santiago Del Estero;34;4;19;1;30;88;89,76
2015;4;Tierra Del Fuego;23;4;665;1;2;695;708,9
2015;4;Tucumán;144;2;116;88;50;400;408
2015;3;Buenos Aires;2;1;114;20;26;163;166,26
2015;3;Capital Federal;455;871;31;2;13;1372;1399,44
2015;3;Catamarca;26;242;15;1;34;318;324,36
2015;3;Chaco;56;29;186;52;41;364;371,28
2015;3;Chubut;44;792;916;13;5;1770;1805,4
2015;3;Córdoba;352;264;1;5;389;1011;1031,22
2015;3;Corrientes;56;28;176;1;47;308;314,16
2015;3;Entre Ríos;114;52;122;6;197;491;500,82
2015;3;Formosa;22;5;2;899;14;942;960,84
2015;3;Jujuy;33;7;22;0;35;97;98,94
2015;3;La Pampa;13;42;4;6;557;622;634,44
2015;3;La Rioja;17;0;16;2;28;63;64,26
2015;3;Mendoza;153;13;3;42;2;213;217,26
2015;3;Misiones;60;32;46;5;15;158;161,16
2015;3;Neuquén;47;37;1;13;3;101;103,02
2015;3;Río Negro;67;27;917;3;1;1015;1035,3
2015;3;Salta;78;22;47;129;645;921;939,42
2015;3;San Juan;49;451;770;1;908;2179;2222,58
2015;3;San Luis;11;1;354;31;377;774;789,48
2015;3;Santa Cruz;16;3;396;5;2;422;430,44
2015;3;Santa Fe;337;210;4;4;1;556;567,12
2015;3;Santiago Del Estero;34;4;19;1;30;88;89,76
2015;3;Tierra Del Fuego;23;8;665;1;2;699;712,98
2015;3;Tucumán;143;1;116;88;50;398;405,96
2015;2;Buenos Aires;2;1;116;19;26;164;167,28
2015;2;Capital Federal;453;858;20;2;13;1346;1372,92
2015;2;Catamarca;25;242;15;1;34;317;323,34
2015;2;Chaco;56;28;179;52;41;356;363,12
2015;2;Chubut;44;762;916;13;5;1740;1774,8
2015;2;Córdoba;348;256;435;5;386;1430;1458,6
2015;2;Corrientes;55;27;157;1;47;287;292,74
2015;2;Entre Ríos;113;50;119;6;197;485;494,7
2015;2;Formosa;21;5;2;737;50;815;831,3
2015;2;Jujuy;32;5;22;0;35;94;95,88
2015;2;La Pampa;13;41;4;6;562;626;638,52
2015;2;La Rioja;16;0;16;2;28;62;63,24
2015;2;Mendoza;153;13;3;38;2;209;213,18
2015;2;Misiones;59;29;37;5;15;145;147,9
2015;2;Neuquén;47;34;1;13;3;98;99,96
2015;2;Río Negro;67;26;916;3;1;1013;1033,26
2015;2;Salta;77;20;47;129;580;853;870,06
2015;2;San Juan;49;451;770;1;908;2179;2222,58
2015;2;San Luis;11;1;354;33;377;776;791,52
2015;2;Santa Cruz;15;3;396;5;2;421;429,42
2015;2;Santa Fe;333;205;3;4;1;546;556,92
2015;2;Santiago Del Estero;34;4;19;1;30;88;89,76
2015;2;Tierra Del Fuego;23;8;665;1;2;699;712,98
2015;2;Tucumán;140;479;116;88;50;873;890,46
2015;1;Buenos Aires;2;1;134;19;29;185;188,7
2015;1;Capital Federal;455;842;19;2;15;1333;1359,66
2015;1;Catamarca;25;241;16;1;41;324;330,48
2015;1;Chaco;55;26;164;27;56;328;334,56
2015;1;Chubut;46;717;906;13;5;1687;1720,74
2015;1;Córdoba;344;248;415;5;450;1462;1491,24
2015;1;Corrientes;55;25;129;1;62;272;277,44
2015;1;Entre Ríos;112;47;108;6;245;518;528,36
2015;1;Formosa;21;5;1;670;56;753;768,06
2015;1;Jujuy;32;5;22;0;36;95;96,9
2015;1;La Pampa;13;40;3;6;604;666;679,32
2015;1;La Rioja;16;0;16;2;33;67;68,34
2015;1;Mendoza;152;13;3;29;2;199;202,98
2015;1;Misiones;58;27;30;5;13;133;135,66
2015;1;Neuquén;48;32;1;12;3;96;97,92
2015;1;Río Negro;66;25;907;3;1;1002;1022,04
2015;1;Salta;76;20;47;129;574;846;862,92
2015;1;San Juan;48;451;755;1;1;1256;1281,12
2015;1;San Luis;11;1;351;30;412;805;821,1
2015;1;Santa Cruz;16;3;392;5;3;419;427,38
2015;1;Santa Fe;329;199;3;4;2;537;547,74
2015;1;Santiago Del Estero;34;4;19;1;35;93;94,86
2015;1;Tierra Del Fuego;22;8;657;1;3;691;704,82
2015;1;Tucumán;138;115;116;88;100;557;568,14
2014;4;Buenos Aires;2;1;121;18;32;174;177,48
2014;4;Capital Federal;456;840;17;2;15;1330;1356,6
2014;4;Catamarca;25;241;16;0;44;326;332,52
2014;4;Chaco;55;11;31;0;62;159;162,18
2014;4;Chubut;49;697;891;12;6;1655;1688,1
2014;4;Córdoba;345;240;419;4;486;1494;1523,88
2014;4;Corrientes;55;10;40;1;75;181;184,62
2014;4;Entre Ríos;112;23;57;5;260;457;466,14
2014;4;Formosa;21;5;1;0;65;92;93,84
2014;4;Jujuy;31;5;22;37;11;106;108,12
2014;4;La Pampa;16;34;514;6;648;1218;1242,36
2014;4;La Rioja;16;0;17;0;33;66;67,32
2014;4;Mendoza;152;13;3;31;2;201;205,02
2014;4;Misiones;58;19;16;150;15;258;263,16
2014;4;Neuquén;48;32;1;12;3;96;97,92
2014;4;Río Negro;66;24;901;4;2;997;1016,94
2014;4;Salta;76;17;48;6;578;725;739,5
2014;4;San Juan;49;451;740;1;1;1242;1266,84
2014;4;San Luis;11;926;355;24;423;1739;1773,78
2014;4;Santa Cruz;18;448;388;4;3;861;878,22
2014;4;Santa Fe;335;183;3;6;2;529;539,58
2014;4;Santiago Del Estero;34;4;19;920;37;1014;1034,28
2014;4;Tierra Del Fuego;22;4;655;1;3;685;698,7
2014;4;Tucumán;137;97;116;13;105;468;477,36
2014;3;Buenos Aires;2;1;124;20;32;179;182,58
2014;3;Capital Federal;450;833;18;2;14;1317;1343,34
2014;3;Catamarca;24;244;15;0;47;330;336,6
2014;3;Chaco;53;10;29;1;59;152;155,04
2014;3;Chubut;49;668;882;12;7;1618;1650,36
2014;3;Córdoba;340;240;444;4;377;1405;1433,1
2014;3;Corrientes;53;9;31;1;65;159;162,18
2014;3;Entre Ríos;109;22;48;5;135;319;325,38
2014;3;Formosa;21;5;0;0;80;106;108,12
2014;3;Jujuy;30;4;22;37;13;106;108,12
2014;3;La Pampa;16;34;538;11;677;1276;1301,52
2014;3;La Rioja;16;0;14;1;37;68;69,36
2014;3;Mendoza;150;13;3;40;2;208;212,16
2014;3;Misiones;57;18;4;3;14;96;97,92
2014;3;Neuquén;54;31;1;13;3;102;104,04
2014;3;Río Negro;65;27;888;4;2;986;1005,72
2014;3;Salta;74;18;43;109;580;824;840,48
2014;3;San Juan;48;451;731;1;1;1232;1256,64
2014;3;San Luis;11;925;355;25;438;1754;1789,08
2014;3;Santa Cruz;18;492;385;4;3;902;920,04
2014;3;Santa Fe;326;184;4;7;733;1254;1279,08
2014;3;Santiago Del Estero;33;4;19;768;41;865;882,3
2014;3;Tierra Del Fuego;22;3;650;1;3;679;692,58
2014;3;Tucumán;132;97;117;13;100;459;468,18
2014;2;Buenos Aires;2;1;120;17;33;173;176,46
2014;2;Capital Federal;448;828;18;2;15;1311;1337,22
2014;2;Catamarca;24;243;17;0;43;327;333,54
2014;2;Chaco;53;10;30;0;58;151;154,02
2014;2;Chubut;51;649;866;11;7;1584;1615,68
2014;2;Córdoba;338;235;351;4;374;1302;1328,04
2014;2;Corrientes;53;9;31;1;55;149;151,98
2014;2;Entre Ríos;109;22;49;5;133;318;324,36
2014;2;Formosa;21;5;0;0;78;104;106,08
2014;2;Jujuy;30;4;23;40;9;106;108,12
2014;2;La Pampa;16;33;513;6;689;1257;1282,14
2014;2;La Rioja;16;0;14;0;34;64;65,28
2014;2;Mendoza;149;13;2;36;2;202;206,04
2014;2;Misiones;57;18;4;150;8;237;241,74
2014;2;Neuquén;48;30;997;11;3;1089;1110,78
2014;2;Río Negro;65;25;876;4;2;972;991,44
2014;2;Salta;74;18;45;7;577;721;735,42
2014;2;San Juan;48;451;722;1;1;1223;1247,46
2014;2;San Luis;11;925;354;22;448;1760;1795,2
2014;2;Santa Cruz;19;448;381;4;3;855;872,1
2014;2;Santa Fe;324;178;3;6;636;1147;1169,94
2014;2;Santiago Del Estero;33;4;19;907;34;997;1016,94
2014;2;Tierra Del Fuego;22;3;648;1;3;677;690,54
2014;2;Tucumán;132;97;121;13;98;461;470,22
2014;1;Buenos Aires;2;1;121;17;34;175;178,5
2014;1;Capital Federal;446;820;18;2;15;1301;1327,02
2014;1;Catamarca;24;46;17;0;43;130;132,6
2014;1;Chaco;53;9;30;0;58;150;153
2014;1;Chubut;51;539;866;11;7;1474;1503,48
2014;1;Córdoba;337;226;347;4;368;1282;1307,64
2014;1;Corrientes;53;8;31;1;55;148;150,96
2014;1;Entre Ríos;108;21;49;5;133;316;322,32
2014;1;Formosa;21;5;0;0;100;126;128,52
2014;1;Jujuy;30;4;23;0;9;66;67,32
2014;1;La Pampa;16;31;513;6;701;1267;1292,34
2014;1;La Rioja;16;0;14;0;34;64;65,28
2014;1;Mendoza;149;12;2;37;2;202;206,04
2014;1;Misiones;57;17;4;150;8;236;240,72
2014;1;Neuquén;48;28;997;10;3;1086;1107,72
2014;1;Río Negro;65;24;876;4;2;971;990,42
2014;1;Salta;73;18;45;8;568;712;726,24
2014;1;San Juan;48;434;722;808;1;2013;2053,26
2014;1;San Luis;11;428;354;21;448;1262;1287,24
2014;1;Santa Cruz;19;100;381;4;3;507;517,14
2014;1;Santa Fe;323;174;3;6;644;1150;1173
2014;1;Santiago Del Estero;33;4;19;915;34;1005;1025,1
2014;1;Tierra Del Fuego;22;3;648;1;3;677;690,54
2014;1;Tucumán;130;83;121;13;98;445;453,9
